731
An Interactive Fiction
Release 1 / Serial number 151217 / Inform 7 build 6L38 (I6/v6.33 lib 6/12N) SD

canyon crest
you are on the crest of a canyon. it is a bright sunny day.

the path goes east and west.

0

>east
trailhead
there are some rocks.

the trail goes east and west. a path leads south

0

>downhill
That's not a verb I recognise.

* * *

>east
trailhead
there are some rocks.

the trail goes east and west. a path leads south

0

>south
glass houses
some glass houses... you can go inside one.

>inside
glass house
you are inside the glass house.

there is a door south of here.

>south
canyon crest
you are on the crest of a canyon. it is a bright sunny day.

the path goes east and west.

>north
glass house
you are inside the glass house.

there is a door south of here.

* * *

>inside
glass house
you are inside the glass house.

there is a door south of here.

>west
back of the canyon
you can see the city from here.... a peaceful sunny day with the light yellow through dust

the path goes east and west.

>west
trailhead
there are some rocks.

the trail goes east and west. a path leads south

>south
canyon crest
you are on the crest of a canyon. it is a bright sunny day.

the path goes east and west.

* * *

>south
glass houses
some glass houses... you can go inside one.

>south
You can't go that way.

>inside
glass house
you are inside the glass house.

there is a door south of here.

* * *

>south
canyon crest
you are on the crest of a canyon. it is a bright sunny day.

the path goes east and west.

>north
You can't go that way.

>south
You can't go that way.

>est
That's not a verb I recognise.

>west
back of the canyon
you can see the city from here.... a peaceful sunny day with the light yellow through dust

the path goes east and west.

* * *

>west
trailhead
there are some rocks.

the trail goes east and west. a path leads south

>south
glass houses
some glass houses...

>south
You can't go that way.

* * *

>east
trailhead
there are some rocks.

the trail goes east and west. a path leads south

0

>east
back of the canyon
you can see the city from here.... a peaceful sunny day with the light yellow through dust

the path goes east and west.

0

>west
trailhead
there are some rocks.

the trail goes east and west. a path leads south

0

>south
glass houses
some glass houses... you can go inside one.

0

>inside
glass house
you are inside the glass house.

there is a door south of here.

0

>south
canyon crest
you are on the crest of a canyon. it is a bright sunny day.

the path goes east and west.

1

>east
trailhead
there are some rocks.

the trail goes east and west. a path leads south

1

>east
back of the canyon
you can see the city from here.... a peaceful sunny day with the light yellow through dust

the path goes east and west.

1

>south
You can't go that way.

1

>east
canyon crest
you are on the crest of a canyon. it is a bright sunny day.

the path goes east and west.

1

>west
back of the canyon
you can see the city from here.... a peaceful sunny day with the light yellow through dust

the path goes east and west.

1

>west
trailhead
there are some rocks.

the trail goes east and west. a path leads south

1

>south
glass houses
some glass houses... you can go inside one.

1

>inside
glass house
you are inside the glass house.

there is a door south of here.

1

>south
canyon crest
you are on the crest of a canyon. it is a bright sunny day.

the path goes east and west.

2

* * *

731
An Interactive Fiction
Release 1 / Serial number 151217 / Inform 7 build 6L38 (I6/v6.33 lib 6/12N) SD

canyon crest
you are on the crest of a canyon. it is a bright sunny day.

the path goes east and west.

0

>west
back of the canyon
In this garden grow plants that eat insects and plants that eat birds. It is bordered by a bone fence, and the pavements are made of a giant's kneecaps.

In the center of the garden is Baba Yaga's hut, which walks on chicken legs. Currently the hut is squatting on the ground.

* * *

731
An Interactive Fiction
Release 1 / Serial number 151217 / Inform 7 build 6L38 (I6/v6.33 lib 6/12N) SD

canyon crest
you are on the crest of a canyon. it is a bright sunny day.

the path goes east and west.

0

>go west
back of the canyon
In this garden grow plants that eat insects and plants that eat birds. It is bordered by a bone fence, and the pavements are made of a giant's kneecaps.

In the center of the garden is Baba Yaga's hut, which walks on chicken legs. Currently the hut is squatting on the ground.